A--O--C--C---
-B-B-B-B-B-B-
-B-B-BBB-B-B-
-B-B-M-M-B-B-
-B-B-----B-B-
-------------
B-BB-----BB-B
-----B-B-----
-B-B-MMM-B-B-
-B-B-B-B-B-B-
-B-B-----B-B-
-B-B-BBB-B-B-
----PBFB-----